1,1,1,1,1,1,1,1,1,1,1,1,1,4,1,1,1,1,1,1,1,1,1,1,1,1,1,1,1,1
1,1,1,4,1,1,1,1,1,1,1,1,1,4,1,1,1,1,1,1,1,1,1,1,1,1,1,1,1,1
1,1,1,4,1,1,1,1,1,1,1,1,1,4,1,1,1,1,1,1,1,1,1,1,1,1,1,1,1,1
1,1,1,4,4,4,4,4,4,4,4,4,1,1,1,4,4,4,4,4,4,1,1,1,1,1,1,1,4,1
1,1,1,1,1,1,1,1,1,1,1,4,1,1,1,4,1,1,1,1,4,1,1,1,1,1,1,1,4,1
1,1,1,1,1,1,1,1,1,1,1,4,1,1,1,4,1,1,1,1,4,1,1,1,1,1,1,1,4,1
1,1,1,1,1,1,1,1,1,1,1,4,1,1,1,4,1,1,1,1,4,1,1,1,1,1,1,1,4,1
1,1,1,1,1,1,1,1,1,1,1,4,1,1,1,4,1,1,1,1,4,4,4,4,4,4,4,4,4,1
1,1,1,1,1,1,5,1,1,1,1,4,1,1,1,4,1,1,1,1,1,1,1,1,1,1,1,1,1,1
1,1,1,1,1,1,1,1,1,1,4,1,1,1,1,1,4,1,1,1,1,1,1,1,1,1,1,1,1,1
1,1,1,1,1,1,1,1,1,4,1,1,1,4,1,1,1,4,1,1,1,1,1,1,1,1,1,1,1,1
1,1,1,1,1,1,1,1,4,1,1,1,4,4,4,1,1,1,4,4,4,4,4,4,4,4,4,4,4,1
4,4,4,4,4,4,4,4,1,1,1,4,4,4,4,4,1,1,1,1,1,1,1,1,1,1,1,4,4,1
1,1,1,1,1,1,1,1,1,1,4,4,4,4,4,4,4,1,1,1,1,1,1,1,1,1,1,1,4,1
1,1,1,1,1,1,1,1,1,4,4,4,4,4,4,4,4,4,1,1,1,1,1,1,1,1,1,1,4,1
1,1,1,1,1,1,1,1,1,1,4,4,4,4,4,4,4,1,1,1,1,1,1,1,1,1,1,1,4,1
4,4,4,4,4,4,4,4,1,1,1,4,4,4,4,4,1,1,1,1,1,1,1,1,1,1,1,1,4,1
4,4,4,4,4,4,4,4,4,1,1,1,4,4,4,1,1,1,4,4,4,4,4,4,4,4,1,1,4,1
4,4,4,4,4,4,4,4,4,4,1,1,1,4,1,1,1,4,1,1,1,1,1,1,4,4,1,1,4,1
4,4,4,4,4,4,4,4,4,4,4,1,1,1,1,1,4,1,1,1,1,1,1,1,1,4,1,1,4,1
1,1,1,1,1,1,1,4,4,4,4,4,1,1,1,4,1,1,1,1,1,1,1,1,1,4,1,1,4,1
1,1,1,1,1,1,1,4,4,4,4,4,4,1,4,1,1,1,1,1,1,1,1,1,1,4,1,1,4,1
1,1,1,1,1,1,1,1,1,4,4,4,4,1,4,1,1,1,1,1,1,1,1,1,1,4,1,1,4,1
1,1,1,1,1,1,1,1,1,1,4,4,4,1,4,1,1,1,1,1,1,1,1,1,1,4,1,1,4,1
1,1,1,1,1,1,1,1,1,1,1,4,4,1,4,1,1,1,1,1,1,1,1,1,1,4,1,1,4,1
1,1,1,1,1,1,1,1,1,1,1,4,4,1,4,1,1,1,1,1,1,1,1,1,4,1,1,1,4,1
1,1,1,1,1,1,1,1,1,1,1,4,4,1,4,1,1,1,1,1,1,1,1,4,1,1,1,4,1,1
1,1,1,1,1,1,1,1,1,1,1,4,4,1,4,1,1,1,4,4,4,4,4,1,1,1,4,1,1,1
1,1,1,1,1,1,1,1,1,1,1,4,4,1,4,1,1,1,1,1,1,1,1,1,4,4,1,1,1,1
1,1,1,1,1,1,1,1,1,1,1,4,4,6,4,1,1,1,4,4,4,4,4,4,4,1,1,1,1,1
